date,tests1,tests2,tests3,tests4,tests,pos1,pos2,pos3,pos4,daily.pos,cases,sym_pos1,sym_pos2,sym_pos3,sym_pos4,sym_cases,hosps1,hosps2,hosps3,hosps4,Hospitalizations,hosp_deaths1,hosp_deaths2,hosp_deaths3,hosp_deaths4,hosp_deaths,deaths1,deaths2,deaths3,deaths4,deaths,Tot_hosp
2020-02-22,0,0,0,1,1,0,0,0,1,1,1,0,0,0,1,1,0,0,0,0,0,0,0,0,0,0,0,0,0,0,0,0
2020-02-23,0,0,0,0,0,0,0,0,0,0,1,0,0,0,0,1,0,0,0,1,1,0,0,0,0,0,0,0,0,0,0,1
2020-02-24,0,0,0,0,0,0,0,0,0,0,1,0,0,0,0,1,0,1,2,0,3,0,0,0,0,0,0,0,0,0,0,4
2020-02-25,0,1,0,0,1,0,1,0,0,1,2,0,1,0,0,2,0,0,1,0,1,0,0,0,0,0,0,0,0,0,0,5
2020-02-26,0,1,1,0,2,0,1,1,0,2,4,0,1,1,0,4,0,0,0,0,1,0,0,1,0,1,0,0,1,1,2,6
2020-02-27,0,2,2,0,4,0,1,2,0,3,7,0,1,2,0,7,0,1,1,1,3,0,0,0,0,1,0,0,0,0,2,9
2020-02-28,1,4,1,6,12,1,1,1,6,9,16,1,1,1,6,16,0,0,2,1,3,0,0,0,0,1,0,0,1,1,4,12
2020-02-29,1,4,5,7,17,1,3,5,7,16,32,1,3,5,7,32,0,0,0,1,1,0,0,0,0,1,0,0,0,1,5,13
2020-03-01,0,5,7,0,12,0,5,7,0,12,44,0,5,7,0,44,0,0,2,0,2,0,0,0,0,1,0,0,0,3,8,15
2020-03-02,0,8,4,8,20,0,6,4,8,18,62,0,6,4,8,62,0,1,0,3,4,0,0,0,0,1,0,0,0,2,10,19
2020-03-03,0,8,7,5,20,0,5,7,5,17,79,0,5,7,5,79,0,0,2,3,5,0,0,0,0,1,0,0,0,3,13,24
2020-03-04,0,30,8,11,49,0,12,8,11,31,110,0,12,6,11,108,0,1,2,5,8,0,0,0,1,2,0,0,0,2,15,32
2020-03-05,39,47,37,42,165,0,4,14,21,39,149,0,4,12,19,143,0,0,4,10,14,0,0,0,1,3,0,0,1,3,19,46
2020-03-06,15,65,32,24,136,0,6,5,14,25,174,0,6,4,14,167,0,1,1,10,12,0,0,0,0,3,0,0,0,4,23,58
2020-03-07,0,17,6,14,37,0,2,5,14,21,195,0,1,4,14,186,0,0,2,5,7,0,0,0,0,3,0,0,0,0,23,65
2020-03-08,2,17,6,29,54,1,10,5,27,43,238,0,7,4,22,219,0,1,3,9,13,0,0,0,2,5,0,0,1,4,28,78
2020-03-09,1,47,16,18,82,0,11,12,13,36,274,0,8,9,12,248,0,0,4,8,12,0,0,0,2,7,0,0,1,2,31,90
2020-03-10,4,47,18,37,106,2,21,13,35,71,345,2,15,11,26,302,1,2,1,13,17,0,0,0,2,9,0,0,0,2,33,107
2020-03-11,6,51,22,24,103,0,22,17,22,61,406,0,14,9,20,345,0,1,5,9,15,0,0,0,1,10,0,0,0,2,35,122
2020-03-12,7,96,53,29,185,1,35,37,27,100,506,1,19,19,23,407,0,4,6,13,23,0,0,0,3,13,0,0,0,4,39,145
2020-03-13,13,144,56,46,259,7,44,33,36,120,626,6,22,21,24,480,0,4,1,10,15,0,0,0,2,15,0,0,0,3,42,160
2020-03-14,9,119,61,28,217,1,30,25,19,75,701,0,18,20,15,533,0,2,9,5,16,0,0,1,2,18,0,0,1,3,46,176
2020-03-15,6,116,43,23,188,1,21,10,13,45,746,1,14,8,9,565,0,1,6,6,13,0,0,0,2,20,0,0,0,4,50,189
2020-03-16,9,128,74,38,249,3,58,45,34,140,886,2,47,40,31,685,0,3,5,16,24,0,0,1,3,24,0,0,2,4,56,213
2020-03-17,5,154,82,45,286,0,50,40,33,123,1009,0,38,38,29,790,0,2,7,9,18,0,0,0,5,29,0,0,0,7,63,231
2020-03-18,7,188,79,37,311,2,68,52,29,151,1160,2,52,43,24,911,0,2,4,9,15,0,0,1,3,33,0,0,1,3,67,246
2020-03-19,12,173,107,52,344,2,70,56,35,163,1323,2,51,47,25,1036,0,4,5,17,26,0,0,1,3,37,0,0,1,4,72,272
2020-03-20,2,273,52,28,355,1,58,42,27,128,1451,0,52,30,22,1140,0,6,7,12,25,0,0,0,6,43,0,0,1,6,79,297
2020-03-21,2,251,41,23,317,1,32,34,17,84,1535,1,28,28,16,1213,0,3,9,12,24,0,0,1,0,44,0,0,1,3,83,321
2020-03-22,2,308,34,18,362,0,43,28,15,86,1621,0,35,21,12,1281,0,2,11,10,23,0,0,4,2,50,0,0,5,9,97,344
2020-03-23,5,193,89,45,332,4,91,81,42,218,1839,3,78,65,36,1463,0,7,18,23,48,0,0,2,5,57,0,0,2,7,106,392
2020-03-24,0,227,86,27,340,0,83,78,25,186,2025,0,69,69,24,1625,0,5,11,11,27,0,0,1,4,62,0,0,2,7,115,419
2020-03-25,4,341,63,34,442,4,96,58,33,191,2216,2,74,50,27,1778,1,5,13,13,32,0,0,1,7,70,0,0,1,8,124,451
2020-03-26,5,413,75,34,527,3,86,57,32,178,2394,3,69,47,28,1925,0,4,13,10,27,0,0,1,11,82,0,0,1,15,140,478
2020-03-27,2,545,81,52,680,2,91,76,48,217,2611,2,71,60,42,2100,0,10,15,11,36,0,0,1,5,88,0,0,2,7,149,514
2020-03-28,1,239,60,19,319,1,49,44,14,108,2719,1,42,39,12,2194,1,8,15,12,36,0,0,3,5,96,0,0,4,10,163,550
2020-03-29,9,344,59,38,450,7,40,43,35,125,2844,7,35,32,26,2294,0,7,11,18,36,0,0,0,5,101,0,0,0,8,171,586
2020-03-30,8,358,104,42,512,6,109,89,36,240,3084,2,91,72,33,2492,0,3,15,19,37,0,0,1,2,104,0,0,1,4,176,623
2020-03-31,6,368,97,50,521,4,93,81,40,218,3302,2,76,58,38,2666,1,5,15,14,35,0,0,1,2,107,0,0,3,2,181,658
2020-04-01,9,337,91,35,472,8,81,70,27,186,3488,4,65,53,22,2810,0,10,20,11,41,0,2,0,7,116,0,2,0,10,193,699
2020-04-02,13,225,88,49,375,12,84,62,29,187,3675,6,69,52,26,2963,0,10,13,17,40,0,1,0,8,125,0,1,0,10,204,739
2020-04-03,11,361,78,51,501,9,98,60,46,213,3888,6,86,53,43,3151,1,13,15,16,45,0,2,0,7,134,0,2,0,11,217,784
2020-04-04,6,138,58,23,225,5,43,39,20,107,3995,4,31,33,18,3237,0,4,12,10,26,0,0,3,3,140,0,0,4,8,229,810
2020-04-05,4,44,28,23,99,3,34,23,19,79,4074,2,29,21,15,3304,0,5,9,16,30,0,0,2,7,149,0,1,2,13,245,840
2020-04-06,4,102,57,19,182,4,94,54,19,171,4245,2,81,48,17,3452,0,3,7,14,24,0,0,2,4,155,0,0,2,11,258,864
2020-04-07,6,122,70,48,246,6,95,63,46,210,4455,4,79,48,36,3619,0,4,15,11,30,0,0,1,8,164,0,0,1,14,273,894
2020-04-08,10,129,103,32,274,6,63,67,21,157,4612,5,50,48,15,3737,0,8,8,7,23,0,0,0,7,171,0,1,0,10,284,917
2020-04-09,4,154,92,54,304,4,77,50,38,169,4781,3,55,38,25,3858,0,7,10,13,30,0,0,1,3,175,0,0,1,6,291,947
2020-04-10,12,163,93,42,310,7,67,46,21,141,4922,6,56,34,17,3971,1,4,17,11,33,0,0,2,4,181,0,1,2,9,303,980
2020-04-11,3,85,53,31,172,2,26,30,17,75,4997,2,19,23,13,4028,0,6,8,10,24,0,0,1,5,187,0,0,2,8,313,1004
2020-04-12,5,30,21,12,68,3,19,12,8,42,5039,2,12,10,8,4060,0,5,7,5,17,0,0,1,4,192,0,0,1,4,318,1021
2020-04-13,8,88,53,12,161,8,78,52,12,150,5189,5,59,44,11,4179,0,3,7,6,16,0,0,0,6,198,0,0,0,9,327,1037
2020-04-14,5,74,49,22,150,5,62,47,21,135,5324,2,50,40,14,4285,2,5,7,6,20,0,0,1,2,201,0,0,2,3,332,1057
2020-04-15,8,79,50,23,160,8,60,49,21,138,5462,4,51,42,15,4397,0,6,10,5,21,0,2,0,2,205,0,2,0,3,337,1078
2020-04-16,9,74,35,29,147,9,65,35,29,138,5600,7,54,31,21,4510,0,7,7,11,25,0,0,0,9,214,0,0,1,12,350,1103
2020-04-17,12,88,47,20,167,11,79,46,16,152,5752,8,58,34,12,4622,0,8,8,7,23,0,1,3,3,221,0,1,3,4,358,1126
2020-04-18,1,31,19,16,67,1,27,18,16,62,5814,0,23,14,9,4668,0,2,10,9,21,0,0,1,7,229,0,0,1,10,369,1147
2020-04-19,1,32,18,7,58,1,19,17,6,43,5857,1,17,16,5,4707,0,4,8,8,20,0,0,2,5,236,0,0,4,9,382,1167
2020-04-20,6,85,39,17,147,5,70,39,15,129,5986,3,59,32,10,4811,1,1,5,9,16,0,0,0,5,241,0,0,0,7,389,1183
2020-04-21,8,65,39,12,124,7,51,38,12,108,6094,6,42,30,12,4901,0,9,9,4,22,0,0,3,5,249,0,0,4,10,403,1205
2020-04-22,11,194,35,26,266,9,59,30,24,122,6216,7,48,22,21,4999,0,4,6,11,21,0,0,1,2,252,0,1,2,2,408,1226
2020-04-23,6,85,50,25,166,5,58,33,9,105,6321,5,50,23,8,5085,0,5,2,7,14,0,0,1,1,254,0,0,1,4,413,1240
2020-04-24,4,114,68,29,215,4,53,36,22,115,6436,4,49,26,11,5175,0,1,6,4,11,0,0,2,4,260,0,0,3,5,421,1251
2020-04-25,5,63,31,24,123,3,33,17,17,70,6506,3,28,12,13,5231,0,4,7,6,17,0,0,2,5,267,0,0,3,7,431,1268
2020-04-26,3,66,53,36,158,1,26,21,5,53,6559,1,18,16,5,5271,0,3,7,4,14,0,0,1,6,274,0,0,1,8,440,1282
2020-04-27,7,75,47,8,137,7,61,44,8,120,6679,4,49,33,7,5364,0,2,4,2,8,0,1,0,3,278,0,1,0,5,446,1290
2020-04-28,9,110,58,13,190,5,62,31,8,106,6785,4,50,23,7,5448,0,5,3,8,16,0,0,3,1,282,0,0,3,2,451,1306
2020-04-29,17,145,76,31,269,10,61,37,19,127,6912,10,52,28,16,5554,0,3,5,7,15,0,0,2,1,285,0,0,3,3,457,1321
2020-04-30,14,145,62,24,245,10,45,20,10,85,6997,7,34,16,7,5618,0,3,2,2,7,0,0,0,3,288,0,0,0,4,461,1328
2020-05-01,16,264,78,35,393,9,67,40,25,141,7138,6,50,27,14,5715,0,3,3,2,8,0,0,0,6,294,0,0,1,6,468,1336
2020-05-02,11,131,47,28,217,2,27,12,7,48,7186,2,24,8,6,5755,0,4,6,5,15,0,0,0,0,294,0,0,1,3,472,1351
2020-05-03,12,81,37,15,145,1,19,4,2,26,7212,1,12,2,2,5772,0,3,2,1,6,0,0,1,4,299,0,0,1,4,477,1357
2020-05-04,12,102,33,16,163,10,66,25,9,110,7322,7,54,18,5,5856,0,4,3,5,12,0,0,3,1,303,0,1,5,1,484,1369
2020-05-05,8,85,50,16,159,3,44,22,11,80,7402,2,34,18,2,5912,0,4,1,4,9,0,0,3,1,307,0,0,3,1,488,1378
2020-05-06,19,110,41,24,194,13,53,16,15,97,7499,10,44,14,12,5992,0,2,3,5,10,0,0,1,2,310,0,0,1,4,493,1388
2020-05-07,7,126,43,19,195,4,46,22,10,82,7581,4,40,15,8,6059,0,0,2,5,7,0,0,2,2,314,0,0,2,3,498,1395
2020-05-08,24,133,52,16,225,15,40,16,9,80,7661,12,31,15,2,6119,0,4,4,2,10,0,0,0,6,320,0,0,0,6,504,1405
2020-05-09,12,89,34,13,148,4,27,13,5,49,7710,4,22,11,5,6161,0,2,3,2,7,0,0,0,3,323,0,0,0,4,508,1412
2020-05-10,1,33,9,6,49,0,10,4,5,19,7729,0,8,4,5,6178,0,4,3,5,12,0,0,2,5,330,0,0,3,7,518,1424
2020-05-11,8,71,24,6,109,8,54,17,6,85,7814,7,39,15,3,6242,0,3,5,1,9,0,0,0,2,332,0,0,0,2,520,1433
2020-05-12,9,70,23,15,117,9,35,18,13,75,7889,7,26,12,8,6295,0,1,2,3,6,0,0,1,1,334,0,0,1,2,523,1439
2020-05-13,13,82,32,19,146,9,43,16,18,86,7975,6,33,12,8,6354,0,2,3,2,7,0,0,0,0,334,0,0,0,1,524,1446
2020-05-14,10,61,29,9,109,10,34,23,7,74,8049,8,24,16,5,6407,1,3,2,3,9,0,0,0,2,336,0,0,0,3,527,1455
2020-05-15,18,67,37,12,134,17,44,26,10,97,8146,15,38,17,5,6482,0,1,3,2,6,0,0,1,0,337,0,0,1,0,528,1461
2020-05-16,6,32,5,6,49,5,17,4,5,31,8177,3,15,4,2,6506,0,2,3,0,5,0,0,0,2,339,0,0,0,4,532,1466
2020-05-17,1,30,7,3,41,0,9,4,2,15,8192,0,8,3,2,6519,0,0,2,1,3,0,0,2,1,342,0,0,2,2,536,1469
2020-05-18,7,51,18,11,87,7,45,17,11,80,8272,3,35,13,7,6577,0,1,5,3,9,0,0,0,1,343,0,0,0,1,537,1478
2020-05-19,5,49,20,6,80,4,24,15,4,47,8319,2,16,13,3,6611,0,4,3,2,9,0,0,3,1,347,0,0,3,1,541,1487
2020-05-20,16,58,21,13,108,14,35,17,13,79,8398,10,27,8,4,6660,0,2,4,4,10,0,0,0,2,349,0,0,0,3,544,1497
2020-05-21,8,37,16,8,69,6,22,9,7,44,8442,4,17,6,5,6692,0,0,4,1,5,0,0,2,1,352,0,0,2,1,547,1502
2020-05-22,16,48,10,7,81,15,27,6,3,51,8493,9,21,5,3,6730,0,5,3,3,11,0,1,1,0,354,0,1,1,0,549,1513
2020-05-23,1,29,10,1,41,1,13,8,1,23,8516,1,10,6,1,6748,0,1,5,1,7,0,0,1,2,357,0,0,1,3,553,1520
2020-05-24,3,21,13,5,42,2,8,5,4,19,8535,2,7,4,4,6765,0,4,0,4,8,0,0,1,2,360,0,0,1,3,557,1528
2020-05-25,2,26,6,16,50,1,9,5,2,17,8552,1,7,2,1,6776,0,2,2,3,7,0,0,0,2,362,0,0,0,3,560,1535
2020-05-26,10,68,18,9,105,10,38,17,9,74,8626,6,26,12,7,6827,1,0,1,1,3,0,0,0,1,363,0,0,0,1,561,1538
2020-05-27,6,59,16,5,86,6,36,13,4,59,8685,2,27,10,3,6869,0,1,2,3,6,0,1,1,2,367,0,1,2,3,567,1544
2020-05-28,8,82,16,15,121,8,37,10,13,68,8753,4,29,7,6,6915,0,1,0,2,3,0,0,0,1,368,0,0,0,1,568,1547
2020-05-29,5,88,24,9,126,4,54,20,7,85,8838,3,34,9,5,6966,0,1,4,5,10,0,1,1,0,370,0,1,1,1,571,1557
2020-05-30,6,27,8,0,41,6,19,5,0,30,8868,2,15,5,0,6988,0,2,0,1,3,0,0,0,1,371,0,0,0,1,572,1560
2020-05-31,3,29,8,4,44,3,9,3,2,17,8885,1,8,3,2,7002,0,1,2,2,5,0,0,0,1,372,0,0,0,2,574,1565
2020-06-01,5,46,11,5,67,5,32,10,5,52,8937,1,21,3,4,7031,0,1,2,2,5,0,0,1,1,374,0,0,1,1,576,1570
2020-06-02,21,49,16,6,92,20,30,13,5,68,9005,17,23,10,3,7084,0,2,1,0,3,0,0,0,1,375,0,0,0,2,578,1573
2020-06-03,9,63,16,4,92,9,36,8,4,57,9062,5,26,3,4,7122,1,0,0,2,3,0,0,0,1,376,0,0,0,1,579,1576
2020-06-04,2,73,16,1,92,2,24,12,0,38,9100,1,20,7,0,7150,0,0,1,1,2,0,1,0,0,377,0,1,0,1,581,1578
2020-06-05,9,47,14,5,75,8,23,11,2,44,9144,5,16,8,2,7181,0,1,4,2,7,0,0,0,0,377,0,0,0,1,582,1585
2020-06-06,4,37,10,5,56,4,18,7,4,33,9177,3,13,6,3,7206,0,2,0,1,3,0,0,0,1,378,0,0,0,1,583,1588
2020-06-07,1,31,7,3,42,0,9,4,3,16,9193,0,6,4,1,7217,0,3,1,1,5,0,0,1,1,380,0,0,1,2,586,1593
2020-06-08,7,85,13,7,112,6,34,12,6,58,9251,4,26,6,2,7255,0,3,0,2,5,0,0,1,0,381,0,0,2,0,588,1598
2020-06-09,9,186,16,7,218,7,34,4,4,49,9300,3,29,2,3,7292,0,0,3,0,3,0,0,0,1,382,0,0,0,1,589,1601
2020-06-10,6,182,30,53,271,6,34,9,6,55,9355,1,26,5,5,7329,0,1,4,1,6,0,0,0,0,382,0,0,0,0,589,1607
2020-06-11,7,137,37,30,211,5,32,14,5,56,9411,4,23,9,3,7368,0,0,0,2,2,0,0,0,2,384,0,0,0,5,594,1609
2020-06-12,11,90,23,29,153,8,38,15,22,83,9494,6,21,7,11,7413,0,0,0,0,2,0,0,2,1,387,0,0,2,1,597,1611
2020-06-13,5,45,8,5,63,5,29,7,4,45,9539,3,18,1,3,7438,0,0,1,2,3,0,0,0,0,387,0,0,0,1,598,1614
2020-06-14,4,38,12,5,59,3,15,8,4,30,9569,2,13,6,0,7459,1,2,0,0,3,0,0,1,0,388,0,0,1,0,599,1617
2020-06-15,19,87,21,7,134,18,40,17,3,78,9647,6,28,10,3,7506,1,1,2,3,7,0,0,0,0,388,0,0,0,0,599,1624
2020-06-16,14,154,24,4,196,12,60,18,4,94,9741,5,40,12,1,7564,1,1,1,1,4,0,0,0,0,388,0,0,0,1,600,1628
2020-06-17,16,112,17,2,147,14,62,12,1,89,9830,8,43,7,1,7623,0,2,3,0,5,0,0,0,0,388,0,0,0,0,600,1633
2020-06-18,9,180,22,6,217,7,64,12,3,86,9916,4,41,10,2,7680,0,1,2,0,3,0,0,0,1,389,0,0,0,1,601,1636
2020-06-19,15,86,26,16,143,12,51,21,11,95,10011,7,40,15,7,7749,0,2,0,5,7,0,0,0,0,389,0,0,0,0,601,1643
2020-06-20,6,78,14,4,102,5,49,12,2,68,10079,4,42,8,2,7805,0,1,2,3,6,0,0,0,0,389,0,0,0,1,602,1649
2020-06-21,8,65,8,1,82,8,43,7,1,59,10138,3,27,4,0,7839,1,1,2,0,4,0,0,1,1,391,0,0,1,1,604,1653
2020-06-22,19,111,34,13,177,19,96,28,11,154,10292,10,66,25,8,7948,0,5,0,1,6,0,0,0,0,391,0,0,0,1,605,1659
2020-06-23,17,135,25,8,185,17,106,21,5,149,10441,10,76,14,5,8053,0,4,1,3,8,0,0,1,0,392,0,0,1,3,609,1667
2020-06-24,27,122,22,18,189,27,105,20,15,167,10608,19,76,14,11,8173,0,4,0,2,6,0,0,0,0,392,0,0,0,0,609,1673
2020-06-25,28,222,39,36,325,23,101,19,7,150,10758,13,71,13,5,8275,0,3,4,3,10,0,0,0,2,394,0,0,0,2,611,1683
2020-06-26,22,123,24,5,174,21,95,22,5,143,10901,16,59,19,3,8372,0,0,2,2,4,0,0,0,1,395,0,0,0,1,612,1687
2020-06-27,49,118,16,2,185,48,87,16,2,153,11054,32,68,15,2,8489,0,7,1,2,10,0,0,0,1,396,0,0,0,1,613,1697
2020-06-28,12,62,14,4,92,11,34,13,4,62,11116,5,20,10,4,8528,0,2,5,4,11,0,0,0,0,396,0,0,0,0,613,1708
2020-06-29,79,265,39,9,392,76,175,38,8,297,11413,42,116,24,7,8717,0,2,3,1,6,0,0,0,0,0,0,0,0,0,613,1714
2020-06-30,43,278,44,10,375,32,164,35,5,236,11649,17,104,23,4,8865,0,1,2,1,4,0,0,0,0,0,0,0,0,0,613,1718
2020-07-01,40,238,35,13,326,36,167,28,9,240,11889,21,118,16,3,9023,0,2,0,1,3,0,0,0,0,396,0,0,0,2,615,1721
2020-07-02,54,299,42,20,415,53,129,33,17,232,12121,32,87,23,9,9174,0,1,1,3,5,0,0,0,0,396,0,0,1,1,617,1726
2020-07-03,27,134,27,7,195,25,87,19,6,137,12258,21,57,15,4,9271,0,4,2,1,7,0,0,0,2,398,0,0,1,2,620,1733
2020-07-04,9,55,9,4,77,9,41,7,4,61,12319,5,29,6,4,9315,0,0,4,0,4,0,0,0,0,398,0,0,0,0,620,1737
2020-07-05,16,72,21,4,113,15,46,16,4,81,12400,8,33,11,2,9369,0,0,2,4,6,0,0,1,0,399,0,0,1,0,621,1743
2020-07-06,33,195,53,12,293,33,134,51,12,230,12630,18,90,35,6,9518,1,0,6,3,10,0,0,0,2,401,0,0,0,2,623,1753
2020-07-07,34,199,39,17,289,31,163,35,13,242,12872,16,105,26,7,9672,0,4,6,2,12,0,1,0,0,402,0,1,0,1,625,1765
2020-07-08,48,312,45,11,416,41,141,31,7,220,13092,24,100,17,3,9816,0,6,0,2,8,0,0,0,1,403,0,0,0,2,627,1773
2020-07-09,50,223,53,11,337,47,107,40,9,203,13295,26,64,27,6,9939,0,3,5,0,8,0,0,0,3,406,0,0,0,5,632,1781
2020-07-10,37,166,38,7,248,37,145,38,7,227,13522,19,84,28,4,10074,0,3,3,1,7,0,0,0,1,407,0,0,0,1,633,1788
2020-07-11,19,123,17,9,168,19,82,15,6,122,13644,12,51,10,6,10153,0,4,3,3,10,0,0,0,0,407,0,0,0,0,633,1798
2020-07-12,9,115,14,5,143,6,72,12,3,93,13737,0,45,10,1,10209,0,2,6,2,10,0,0,0,0,0,0,0,0,0,633,1808
2020-07-13,43,299,48,6,396,43,168,47,6,264,14001,19,96,32,6,10362,0,2,5,2,9,0,0,0,1,408,0,0,0,1,634,1817
2020-07-14,61,231,52,11,355,48,155,36,6,245,14246,27,86,29,5,10509,0,4,7,1,12,0,0,0,1,409,0,0,0,2,636,1829
2020-07-15,37,211,49,16,313,36,159,40,15,250,14496,18,105,27,11,10670,0,4,2,1,7,0,0,1,0,410,0,0,1,0,637,1836
2020-07-16,26,183,41,14,264,24,118,29,13,184,14680,11,62,17,5,10765,0,4,2,0,6,0,0,0,0,410,0,0,0,0,637,1842
2020-07-17,36,330,50,26,442,35,117,44,26,222,14902,18,75,23,19,10900,0,1,3,5,9,0,0,0,0,0,0,0,0,0,637,1851
2020-07-18,25,119,41,7,192,23,71,30,7,131,15033,14,45,21,3,10983,0,2,4,2,8,0,0,1,0,411,0,0,1,1,639,1859
2020-07-19,10,82,27,21,140,9,46,27,20,102,15135,6,36,18,12,11055,0,6,5,1,12,0,0,0,1,412,0,0,0,2,641,1871
2020-07-20,41,157,50,5,253,41,132,49,3,225,15360,15,83,34,1,11188,0,1,5,5,11,0,0,0,1,413,0,0,0,2,643,1882
2020-07-21,37,205,63,12,317,37,154,60,11,262,15622,23,99,34,7,11351,0,2,4,1,7,0,0,2,0,415,0,0,2,0,645,1889
2020-07-22,47,176,53,12,288,43,133,47,11,234,15856,17,93,33,8,11502,0,4,6,1,11,0,0,2,0,417,0,0,2,0,647,1900
2020-07-23,33,262,47,9,351,28,128,44,8,208,16064,17,97,26,4,11646,0,2,1,1,4,0,0,0,1,418,0,0,0,1,648,1904
2020-07-24,41,138,43,10,232,40,92,37,9,178,16242,20,58,26,4,11754,0,4,4,1,9,0,0,0,0,418,0,0,0,1,649,1913
2020-07-25,19,110,25,4,158,19,92,22,4,137,16379,13,69,12,1,11849,1,3,2,1,7,0,0,0,1,419,0,0,0,1,650,1920
2020-07-26,14,85,24,5,128,14,53,20,4,91,16470,10,34,14,3,11910,1,2,2,5,10,0,0,0,1,420,0,0,0,2,652,1930
2020-07-27,40,171,48,27,286,39,143,48,25,255,16725,14,84,26,13,12047,0,4,7,2,13,0,0,0,0,420,0,0,0,1,653,1943
2020-07-28,51,144,45,26,266,49,114,43,26,232,16957,26,72,24,15,12184,0,0,4,6,10,0,0,0,0,420,0,1,1,1,656,1953
2020-07-29,32,150,42,20,244,32,122,41,19,214,17171,22,83,24,12,12325,0,5,3,2,10,0,0,0,0,420,0,0,1,2,659,1963
2020-07-30,37,451,39,12,539,33,89,34,12,168,17339,14,63,26,11,12439,0,4,7,3,14,0,0,0,0,420,0,0,0,2,661,1977
2020-07-31,37,873,42,18,970,31,84,39,17,171,17510,20,56,34,13,12562,1,2,7,2,12,0,0,2,2,424,0,0,3,3,667,1989
2020-08-01,26,104,30,5,165,26,63,28,4,121,17631,17,52,25,2,12658,0,4,2,4,10,0,0,0,0,424,0,0,0,3,670,1999
2020-08-02,8,56,9,5,78,8,29,7,4,48,17679,3,24,5,4,12694,0,1,4,4,9,0,0,0,1,425,0,0,0,1,671,2008
2020-08-03,33,139,49,15,236,33,101,47,14,195,17874,23,63,35,8,12823,0,2,4,3,9,0,0,0,1,426,0,0,0,3,674,2017
2020-08-04,46,137,54,14,251,44,102,52,14,212,18086,22,68,35,9,12957,0,8,2,4,14,0,1,0,2,429,0,1,0,6,681,2031
2020-08-05,52,142,43,14,251,50,105,39,14,208,18294,22,71,23,13,13086,0,3,3,1,7,0,0,0,1,430,0,0,0,3,684,2038
2020-08-06,47,157,33,12,249,45,105,29,12,191,18485,24,73,19,8,13210,0,2,4,5,11,0,0,1,0,431,0,0,1,0,685,2049
2020-08-07,40,135,36,11,222,36,95,31,10,172,18657,26,68,22,7,13333,0,1,2,5,8,0,0,1,3,435,0,0,1,6,692,2057
2020-08-08,36,108,24,6,174,32,64,21,5,122,18779,21,49,16,3,13422,0,1,5,2,8,0,0,1,1,437,0,0,1,1,694,2065
2020-08-09,21,68,12,5,106,19,37,11,4,71,18850,12,26,4,4,13468,0,1,2,3,6,0,0,1,2,440,0,0,1,2,697,2071
2020-08-10,37,132,55,13,237,37,112,54,13,216,19066,20,68,37,8,13601,0,3,8,3,14,0,0,1,1,442,0,0,1,1,699,2085
2020-08-11,24,105,34,19,182,23,90,33,19,165,19231,16,58,22,8,13705,0,3,2,4,9,0,0,0,0,442,0,0,0,0,699,2094
2020-08-12,34,134,27,9,204,33,97,26,8,164,19395,19,69,19,7,13819,0,1,3,3,7,0,0,1,1,444,0,0,1,3,703,2101
2020-08-13,30,130,36,6,202,29,95,31,5,160,19555,15,69,23,3,13929,0,3,3,4,10,0,0,0,1,445,0,0,0,2,705,2111
2020-08-14,40,136,36,19,231,38,99,35,19,191,19746,24,67,21,15,14056,0,2,4,4,10,0,0,0,3,448,0,0,0,4,709,2121
2020-08-15,23,97,29,10,159,23,77,27,9,136,19882,9,50,17,5,14137,0,2,6,1,9,0,0,2,0,450,0,0,2,1,712,2130
2020-08-16,16,47,9,5,77,15,29,9,5,58,19940,10,21,8,5,14181,0,2,3,4,9,0,0,0,1,451,0,0,0,2,714,2139
2020-08-17,34,161,34,12,241,33,113,29,11,186,20126,17,83,27,9,14317,0,3,2,3,8,0,1,0,1,453,0,1,0,1,716,2147
2020-08-18,15,100,39,22,176,15,58,29,16,118,20244,10,42,17,9,14395,0,2,2,5,9,0,0,1,1,455,0,0,2,2,720,2156
2020-08-19,27,138,46,8,219,25,94,36,8,163,20407,20,68,25,5,14513,0,2,7,4,13,0,0,0,0,455,0,0,1,1,722,2169
2020-08-20,29,161,31,5,226,26,88,25,3,142,20549,16,61,15,1,14606,0,6,3,2,11,0,0,0,0,455,0,1,0,0,723,2180
2020-08-21,30,107,37,9,183,26,73,28,9,136,20685,14,56,22,3,14701,0,2,3,1,6,0,0,0,2,457,0,0,0,2,725,2186
2020-08-22,19,64,21,3,107,19,37,17,3,76,20761,16,25,14,3,14759,0,1,2,0,3,0,0,0,2,459,0,0,0,2,727,2189
2020-08-23,17,60,16,3,96,14,34,16,3,67,20828,11,25,12,3,14810,0,0,6,3,9,0,0,0,0,459,0,0,0,0,727,2198
2020-08-24,28,126,36,7,197,28,107,33,5,173,21001,12,75,25,3,14925,0,2,5,3,10,0,0,0,0,0,0,0,0,0,727,2208
2020-08-25,33,130,30,16,209,30,93,28,15,166,21167,23,70,18,11,15047,0,2,1,2,5,0,1,0,1,461,0,1,0,2,730,2213
2020-08-26,32,102,35,4,173,30,73,31,3,137,21304,17,52,24,1,15141,0,1,3,0,4,0,0,1,2,464,0,0,1,3,734,2217
2020-08-27,23,107,35,6,171,21,66,30,4,121,21425,14,44,22,4,15225,0,2,3,0,5,0,0,0,0,464,0,0,0,0,734,2222
2020-08-28,26,89,33,6,154,25,52,29,5,111,21536,17,39,19,4,15304,0,1,0,1,2,0,0,0,0,0,0,0,0,0,734,2224
2020-08-29,22,66,21,1,110,22,46,16,1,85,21621,11,29,9,0,15353,0,1,1,0,2,0,0,0,0,0,0,0,0,0,734,2226
2020-08-30,10,35,6,3,54,9,13,5,2,29,21650,6,9,4,1,15373,0,1,2,0,3,0,0,0,0,464,0,0,0,1,735,2229
2020-08-31,27,99,24,9,159,25,77,23,8,133,21783,11,39,14,6,15443,1,2,1,5,9,0,0,0,1,465,0,0,0,3,738,2238
2020-09-01,23,154,26,12,215,21,75,21,10,127,21910,15,60,13,6,15537,0,3,4,0,7,0,0,0,0,465,0,0,0,0,738,2245
2020-09-02,34,394,61,11,500,24,74,17,5,120,22030,17,54,12,5,15625,1,7,1,4,13,0,0,1,1,467,0,0,1,1,740,2258
2020-09-03,24,100,33,5,162,22,72,29,4,127,22157,11,53,20,3,15712,0,2,1,2,5,0,0,0,1,468,0,0,0,2,742,2263
2020-09-04,22,89,16,7,134,19,51,13,7,90,22247,14,36,10,5,15777,0,2,4,0,6,0,0,0,0,468,0,0,0,0,742,2269
2020-09-05,12,65,31,4,112,10,46,30,4,90,22337,7,29,24,2,15839,0,1,4,3,8,0,0,1,2,471,0,0,2,2,746,2277
2020-09-06,6,37,8,5,56,6,21,7,5,39,22376,3,14,4,5,15865,2,2,1,1,6,0,0,0,0,471,0,0,0,1,747,2283
2020-09-07,12,56,10,5,83,12,43,10,5,70,22446,9,30,8,4,15916,0,1,0,1,2,0,0,0,1,472,0,0,0,1,748,2285
2020-09-08,25,78,22,3,128,24,70,22,3,119,22565,15,53,17,2,16003,0,1,0,1,2,0,0,0,0,472,0,0,0,0,748,2287
2020-09-09,39,108,16,6,169,39,76,14,6,135,22700,21,43,5,3,16075,0,1,3,2,6,0,0,0,0,0,0,0,0,0,748,2293
2020-09-10,30,128,32,9,199,25,58,28,7,118,22818,13,41,16,6,16151,0,0,2,2,4,0,0,0,0,0,0,0,0,0,748,2297
2020-09-11,25,178,31,7,241,16,45,23,2,86,22904,7,32,19,2,16211,0,1,1,2,4,0,0,1,1,474,0,0,1,1,750,2301
2020-09-12,17,57,14,3,91,16,32,14,2,64,22968,13,24,11,2,16261,0,1,1,1,3,0,0,0,0,474,0,0,0,0,750,2304
2020-09-13,5,30,9,2,46,5,18,9,1,33,23001,4,15,7,0,16287,0,0,0,0,3,0,0,0,1,475,0,0,0,1,751,2307
2020-09-14,27,261,49,10,347,20,74,24,5,123,23124,11,55,21,3,16377,0,2,2,1,5,0,0,0,0,475,0,0,0,0,751,2312
2020-09-15,15,79,35,16,145,14,53,20,8,95,23219,12,38,11,6,16444,0,0,2,0,2,0,1,0,0,476,0,1,0,2,754,2314
2020-09-16,30,121,48,18,217,15,60,17,3,95,23314,9,49,12,2,16516,0,2,3,1,6,0,0,1,1,478,0,0,1,1,756,2320
2020-09-17,17,114,34,7,172,17,64,30,5,116,23430,11,50,21,4,16602,0,1,2,1,4,0,0,0,0,478,0,0,0,0,756,2324
2020-09-18,28,117,36,5,186,18,58,23,3,102,23532,11,50,21,2,16686,1,0,1,1,3,0,0,0,0,478,0,0,0,1,757,2327
2020-09-19,12,78,18,2,110,11,54,14,1,80,23612,6,42,13,1,16748,0,1,3,1,5,0,0,0,0,478,0,0,0,0,757,2332
2020-09-20,3,19,6,4,32,3,11,6,3,23,23635,2,8,6,3,16767,0,2,1,2,5,0,0,2,0,480,0,1,2,0,760,2337
2020-09-21,11,138,36,5,190,11,81,31,5,128,23763,9,61,23,3,16863,0,6,2,1,9,0,0,1,0,481,0,0,1,0,761,2346
2020-09-22,38,391,58,15,502,22,74,14,6,116,23879,13,62,11,6,16955,0,3,2,3,8,0,0,0,0,481,0,0,0,0,761,2354
2020-09-23,22,188,20,7,237,21,76,17,4,118,23997,18,62,14,4,17053,0,1,2,0,3,0,0,0,0,0,0,0,0,0,761,2357
2020-09-24,31,230,50,9,320,23,83,35,7,148,24145,15,56,30,6,17160,1,1,6,5,13,0,0,0,0,481,0,0,0,1,762,2370
2020-09-25,36,347,78,10,471,18,85,28,5,136,24281,13,62,24,4,17263,0,1,1,6,8,0,0,0,0,481,0,0,0,0,762,2378
2020-09-26,21,80,23,6,130,21,62,22,5,110,24391,15,47,14,4,17343,0,0,1,0,1,0,0,0,1,482,0,0,0,1,763,2379
2020-09-27,10,45,11,2,68,10,25,11,1,47,24438,10,22,8,1,17384,1,0,3,1,5,0,0,0,0,482,0,0,0,0,763,2384
2020-09-28,72,154,52,17,295,68,113,44,9,234,24672,43,88,33,7,17555,0,1,1,1,3,1,0,0,0,483,1,0,0,0,764,2387
2020-09-29,46,138,52,9,245,45,100,45,6,196,24868,35,71,35,2,17698,1,0,4,2,7,0,0,0,1,484,0,0,0,1,765,2394
2020-09-30,61,366,85,39,551,41,84,34,10,169,25037,30,60,25,5,17818,1,4,0,2,7,0,0,0,0,484,0,0,0,1,766,2401
2020-10-01,31,166,31,13,241,31,101,30,12,174,25211,16,70,21,9,17934,0,1,4,7,12,0,0,2,0,486,0,0,3,2,771,2413
2020-10-02,50,187,51,10,298,44,94,33,6,177,25388,30,80,24,4,18072,0,1,1,0,2,0,0,0,0,486,0,0,0,1,772,2415
2020-10-03,29,104,31,10,174,29,75,31,10,145,25533,22,55,24,9,18182,0,1,1,3,5,0,0,0,1,487,0,0,0,1,773,2420
2020-10-04,18,42,16,23,99,18,27,15,23,83,25616,10,21,11,3,18227,0,2,3,1,6,0,0,0,0,487,0,0,0,0,773,2426
2020-10-05,58,346,54,7,465,48,142,37,5,232,25848,33,105,32,3,18400,0,1,3,4,8,0,0,0,3,490,0,0,0,4,777,2434
2020-10-06,51,453,73,19,596,41,101,33,9,184,26032,26,79,25,8,18538,0,2,6,3,11,0,0,0,3,493,0,1,0,3,781,2445
2020-10-07,67,1149,129,38,1383,35,120,32,14,201,26233,29,87,27,11,18692,1,2,4,3,10,0,0,0,3,496,0,0,0,3,784,2455
2020-10-08,38,150,52,11,251,29,93,42,6,170,26403,22,77,34,5,18830,0,2,2,2,6,0,0,1,1,498,0,0,1,1,786,2461
2020-10-09,77,817,102,34,1030,48,112,30,14,204,26607,23,86,19,8,18966,0,1,3,0,4,0,0,0,0,498,0,0,0,0,786,2465
2020-10-10,20,110,26,7,163,16,82,23,5,126,26733,15,66,21,4,19072,0,4,2,6,12,0,0,0,1,499,0,0,0,1,787,2477
2020-10-11,11,65,7,6,89,10,34,6,5,55,26788,5,23,5,5,19110,0,2,1,1,4,0,0,0,0,499,0,0,0,0,787,2481
2020-10-12,89,811,146,37,1083,35,126,45,8,214,27002,18,92,31,5,19256,1,4,1,0,6,0,0,0,2,501,0,0,0,2,789,2487
2020-10-13,29,143,29,5,206,29,116,24,3,172,27174,22,90,23,3,19394,0,1,1,2,4,0,0,0,1,502,0,0,0,1,790,2491
2020-10-14,36,690,86,20,832,28,152,40,9,229,27403,21,112,31,6,19564,1,3,4,5,13,0,0,0,0,502,0,0,0,0,790,2504
2020-10-15,71,460,67,11,609,61,131,36,5,233,27636,50,105,31,4,19754,0,1,4,1,6,0,0,0,0,0,0,0,0,0,790,2510
2020-10-16,50,132,56,7,245,49,92,55,7,203,27839,30,70,45,3,19902,0,4,5,3,12,0,0,0,0,0,0,0,0,0,790,2522
2020-10-17,31,105,29,7,172,28,79,28,4,139,27978,21,65,22,2,20012,0,1,3,3,7,0,0,1,0,503,0,0,1,0,791,2529
2020-10-18,19,61,15,4,99,18,36,12,3,69,28047,13,30,9,2,20066,1,2,2,4,9,0,0,2,0,505,0,0,2,0,793,2538
2020-10-19,46,182,54,21,303,42,151,51,20,264,28311,33,129,39,13,20280,1,1,5,5,12,0,0,1,1,507,0,0,1,1,795,2550
2020-10-20,75,914,137,33,1159,44,176,58,15,293,28604,25,131,44,10,20490,1,1,1,9,12,0,0,0,1,508,0,0,0,1,796,2562
2020-10-21,40,186,32,12,270,39,137,29,11,216,28820,23,105,22,9,20649,0,0,1,3,4,0,0,0,1,509,0,0,0,3,799,2566
2020-10-22,44,547,107,29,727,37,147,52,9,245,29065,25,117,37,7,20835,0,4,2,3,9,0,0,1,0,510,0,0,1,0,800,2575
2020-10-23,43,339,89,24,495,32,137,59,16,244,29309,21,94,48,12,21010,0,2,5,5,12,0,0,0,1,511,0,0,0,2,802,2587
2020-10-24,35,154,42,11,242,34,131,42,11,218,29527,25,97,33,8,21173,0,2,0,4,6,0,0,1,2,514,0,0,1,2,805,2593
2020-10-25,12,56,13,2,83,11,37,13,2,63,29590,8,29,9,2,21221,0,0,0,2,2,0,0,0,1,515,0,0,0,1,806,2595
2020-10-26,61,256,67,12,396,61,233,67,11,372,29962,44,172,52,9,21498,0,2,3,5,10,0,0,0,0,515,0,0,0,0,806,2605
2020-10-27,66,675,129,31,901,45,195,62,24,326,30288,29,138,44,16,21725,0,4,5,4,13,0,0,0,3,518,0,0,0,3,809,2618
2020-10-28,69,274,69,13,425,67,230,68,13,378,30666,43,160,55,12,21995,0,4,5,3,12,0,0,1,0,519,0,0,2,0,811,2630
2020-10-29,88,296,54,18,456,86,247,51,15,399,31065,43,177,37,10,22262,2,6,4,4,16,0,0,0,0,519,0,0,0,0,811,2646
2020-10-30,58,259,72,9,398,56,228,72,8,364,31429,36,158,55,6,22517,0,4,4,0,8,0,0,0,2,521,0,0,0,2,813,2654
2020-10-31,54,207,56,5,322,50,167,52,4,273,31702,34,132,42,2,22727,0,3,2,2,7,0,0,1,0,522,0,0,2,0,815,2661
2020-11-01,16,79,28,6,129,13,50,27,5,95,31797,10,42,19,5,22803,0,1,5,5,11,0,0,0,0,522,0,0,0,0,815,2672
2020-11-02,89,482,129,26,726,84,327,113,24,548,32345,46,243,90,16,23198,0,2,5,4,11,0,0,1,1,524,0,0,1,1,817,2683
2020-11-03,88,409,110,11,618,85,309,106,10,510,32855,53,230,71,9,23561,0,6,4,3,13,0,0,1,0,525,0,0,1,0,818,2696
2020-11-04,144,612,150,25,931,97,385,117,18,617,33472,59,273,90,16,23999,0,4,4,7,15,0,0,0,0,525,0,0,0,1,819,2711
2020-11-05,97,622,154,36,909,91,349,114,28,582,34054,60,230,83,19,24391,0,1,5,7,13,0,0,0,0,525,0,0,1,0,820,2724
2020-11-06,128,663,138,38,967,120,377,103,33,633,34687,69,250,70,25,24805,0,6,11,6,23,0,0,0,1,526,0,0,0,1,821,2747
2020-11-07,102,349,99,21,571,102,327,98,21,548,35235,62,243,73,17,25200,1,5,12,8,26,0,0,0,1,527,0,0,0,1,822,2773
2020-11-08,24,103,35,12,174,23,94,34,12,163,35398,16,57,24,9,25306,2,7,6,6,21,0,0,0,1,528,0,0,0,1,823,2794
2020-11-09,144,656,172,43,1015,138,496,158,42,834,36232,64,333,101,27,25831,0,9,11,9,29,0,0,2,1,531,0,0,2,1,826,2823
2020-11-10,118,721,144,46,1029,113,455,124,45,737,36969,57,251,67,20,26226,0,7,9,4,20,0,0,0,4,535,0,0,0,5,831,2843
2020-11-11,107,612,154,34,907,105,446,138,33,722,37691,50,223,72,23,26594,1,4,9,8,22,0,0,0,1,536,0,0,0,1,832,2865
2020-11-12,170,859,185,43,1257,160,489,147,40,836,38527,71,222,75,22,26984,1,9,5,2,17,0,0,0,1,537,0,0,0,1,833,2882
2020-11-13,126,588,171,40,925,124,501,163,40,828,39355,51,235,83,27,27380,0,7,10,19,36,0,0,0,1,538,0,0,0,1,834,2918
2020-11-14,142,482,159,49,832,134,434,157,44,769,40124,58,229,89,28,27784,0,13,9,7,29,0,0,0,2,540,0,0,0,2,836,2947
2020-11-15,55,182,51,21,309,53,136,45,21,255,40379,25,73,29,13,27924,0,7,8,9,24,0,0,0,1,541,0,0,0,2,838,2971
2020-11-16,148,725,209,57,1139,141,670,209,57,1077,41456,69,387,130,38,28548,2,7,11,10,30,0,0,0,3,544,0,0,0,4,842,3001
2020-11-17,148,660,168,62,1038,144,608,168,62,982,42438,60,307,96,35,29046,1,3,7,16,27,0,0,0,2,546,0,0,0,2,844,3028
2020-11-18,150,587,180,46,963,149,523,177,43,892,43330,48,229,87,31,29441,0,13,10,14,37,0,0,0,0,546,0,0,0,1,845,3065
2020-11-19,170,620,175,36,1001,167,564,173,36,940,44270,58,230,72,19,29820,0,9,13,6,28,0,0,0,4,550,0,0,0,4,849,3093
2020-11-20,175,609,223,69,1076,172,567,216,67,1022,45292,65,240,102,25,30252,2,10,13,9,34,0,0,0,1,551,0,0,1,1,851,3127
2020-11-21,129,481,148,29,787,127,437,145,29,738,46030,38,218,71,14,30593,1,11,6,5,23,0,0,0,4,555,0,0,0,7,858,3150
2020-11-22,45,253,90,22,410,39,189,86,21,335,46365,14,76,45,10,30738,0,4,13,9,26,0,0,0,3,558,0,0,1,6,865,3176
2020-11-23,156,724,230,44,1154,153,642,227,43,1065,47430,59,330,106,21,31254,1,4,18,14,37,0,0,0,1,559,0,0,0,2,867,3213
2020-11-24,153,597,179,49,978,150,566,176,49,941,48371,61,303,92,32,31742,1,2,9,9,21,0,0,2,1,562,0,0,2,1,870,3234
2020-11-25,137,554,190,76,957,135,509,188,76,908,49279,56,263,101,44,32206,0,3,11,15,29,0,0,1,1,564,0,0,1,3,874,3263
2020-11-26,25,115,35,18,193,25,92,33,18,168,49447,9,39,16,14,32284,1,8,8,10,27,0,0,1,0,565,0,0,3,3,880,3290
2020-11-27,137,541,200,61,939,137,509,200,61,907,50354,62,256,113,30,32745,1,7,13,13,34,0,0,0,1,566,0,0,0,1,881,3324
2020-11-28,140,493,153,39,825,140,449,152,39,780,51134,48,254,98,23,33168,0,5,11,9,25,0,0,0,4,570,0,0,0,5,886,3349
2020-11-29,33,177,52,18,280,33,154,52,18,257,51391,17,78,27,11,33301,1,9,12,6,28,0,0,1,0,571,0,0,1,2,889,3377
2020-11-30,206,791,278,110,1385,205,730,278,110,1323,52714,77,362,134,53,33927,0,7,10,8,25,0,0,1,5,577,0,0,2,8,899,3402
2020-12-01,130,596,189,61,976,130,557,189,61,937,53651,44,247,94,39,34351,0,10,8,12,30,0,0,4,1,582,0,0,4,2,905,3432
2020-12-02,125,500,178,48,851,125,461,177,48,811,54462,44,223,88,23,34729,0,8,9,16,33,0,0,3,4,589,0,0,4,7,916,3465
2020-12-03,185,562,203,56,1006,184,500,203,56,943,55405,67,221,94,27,35138,1,7,11,11,30,0,0,0,7,596,0,0,0,10,926,3495
2020-12-04,167,499,182,80,928,166,452,180,80,878,56283,65,194,100,33,35530,0,4,20,10,34,0,1,1,6,604,0,1,2,8,937,3529
2020-12-05,104,382,132,43,661,102,343,132,43,620,56903,41,162,69,20,35822,1,6,8,11,26,0,0,0,2,606,0,0,1,5,943,3555
2020-12-06,49,194,47,14,304,49,127,47,14,237,57140,22,63,21,11,35939,0,2,7,12,21,0,1,0,1,608,0,1,0,2,946,3576
2020-12-07,182,771,225,68,1246,181,681,225,68,1155,58295,85,377,110,35,36546,0,3,19,11,33,0,0,1,4,613,0,0,1,10,957,3609
2020-12-08,113,497,168,99,877,113,452,167,98,830,59125,52,225,84,40,36947,1,6,6,10,23,0,1,1,2,617,0,1,3,3,964,3632
2020-12-09,126,500,141,48,815,126,443,141,48,758,59883,67,250,82,34,37380,2,3,20,16,41,0,0,0,5,622,0,0,0,7,971,3673
2020-12-10,109,551,143,49,852,109,382,143,49,683,60566,60,222,73,31,37766,3,4,11,10,28,0,0,2,5,629,0,0,2,9,982,3701
2020-12-11,129,516,186,51,882,128,410,186,50,774,61340,60,249,112,32,38219,5,9,12,9,35,0,0,4,2,635,0,0,5,5,992,3736
2020-12-12,103,363,117,33,616,103,310,117,32,562,61902,52,194,73,24,38562,0,6,8,8,22,0,0,1,3,639,0,0,1,5,998,3758
2020-12-13,29,155,48,27,259,29,107,48,27,211,62113,12,57,26,14,38671,0,4,12,17,33,0,0,0,5,644,0,1,0,10,1009,3791
2020-12-14,145,577,171,59,952,145,509,171,59,884,62997,78,318,94,36,39197,1,13,8,13,35,0,0,1,4,649,0,0,1,5,1015,3826
2020-12-15,109,476,161,64,810,109,414,159,64,746,63743,50,242,88,32,39609,1,8,11,13,33,0,0,0,2,651,0,0,2,6,1023,3859
2020-12-16,107,473,136,64,780,107,391,136,64,698,64441,46,207,86,34,39982,0,4,7,11,22,0,0,1,5,657,0,0,1,11,1035,3881
2020-12-17,101,454,158,53,766,100,378,157,53,688,65129,53,201,97,29,40362,0,6,12,8,26,0,0,1,5,663,0,0,1,6,1042,3907
2020-12-18,88,400,145,45,678,88,352,145,45,630,65759,45,180,76,25,40688,1,7,7,7,22,0,0,2,1,666,0,0,3,3,1048,3929
2020-12-19,65,299,120,21,505,65,258,120,21,464,66223,29,153,76,10,40956,0,7,11,6,24,0,0,3,3,672,0,0,3,9,1060,3953
2020-12-20,33,195,42,22,292,33,118,42,22,215,66438,14,61,22,14,41067,0,4,11,8,23,0,0,2,2,676,0,0,2,4,1066,3976
2020-12-21,126,488,191,71,876,126,404,191,71,792,67230,62,211,116,34,41490,0,10,9,9,28,0,0,2,5,683,0,0,2,10,1078,4004
2020-12-22,109,406,147,66,728,108,363,147,66,684,67914,54,199,87,29,41859,2,7,10,11,30,0,0,1,6,690,0,0,1,12,1091,4034
2020-12-23,101,380,125,52,658,101,324,125,51,601,68515,54,188,84,30,42215,1,6,5,10,22,0,0,1,2,693,0,0,2,4,1097,4056
2020-12-24,53,257,106,24,440,53,202,105,24,384,68899,31,108,61,16,42431,2,9,7,9,27,0,0,2,8,703,0,0,2,12,1111,4083
2020-12-25,15,74,26,9,124,15,50,26,9,100,68999,6,19,11,6,42473,2,6,9,14,31,0,0,0,0,703,0,0,1,4,1116,4114
2020-12-26,104,406,160,30,700,104,349,159,30,642,69641,52,225,101,21,42872,0,6,9,4,19,0,0,0,1,704,0,0,0,2,1118,4133
2020-12-27,32,176,48,21,277,32,131,48,21,232,69873,10,71,29,17,42999,2,1,6,10,19,0,0,0,4,708,0,0,0,9,1127,4152
2020-12-28,155,621,191,53,1020,152,560,191,53,956,70829,78,297,106,35,43515,1,3,9,7,20,0,0,1,2,711,0,1,1,4,1133,4172
2020-12-29,142,606,158,52,958,141,435,158,52,786,71615,63,235,79,30,43922,1,6,7,9,23,0,0,4,6,721,0,1,7,6,1147,4195
2020-12-30,139,1335,169,59,1702,137,408,167,59,771,72386,56,203,88,28,44297,0,4,12,16,32,0,0,1,3,725,0,0,2,7,1156,4227
2020-12-31,119,476,158,58,811,119,400,158,58,735,73121,42,185,85,25,44634,0,5,8,12,25,0,1,0,5,731,0,1,0,10,1167,4252
2021-01-01,28,175,31,14,248,27,112,31,14,184,73305,11,61,21,9,44736,0,7,13,8,28,0,0,1,3,735,0,0,1,3,1171,4280
2021-01-02,129,507,180,37,853,129,466,180,37,812,74117,57,271,115,18,45197,0,6,10,5,21,0,0,0,4,739,0,0,0,6,1177,4301
2021-01-03,48,207,37,21,313,48,151,37,20,256,74373,15,66,22,13,45313,0,4,12,8,24,0,0,2,1,742,0,0,2,5,1184,4325
2021-01-04,159,738,205,60,1162,159,678,205,60,1102,75475,77,415,118,31,45954,0,7,13,9,29,0,0,0,3,745,0,0,0,5,1189,4354
2021-01-05,146,575,170,60,951,146,485,170,60,861,76336,62,278,92,35,46421,1,9,7,9,26,0,0,2,5,752,0,0,2,8,1199,4380
2021-01-06,125,543,158,55,881,125,462,158,55,800,77136,61,271,98,31,46882,1,3,11,12,27,0,0,0,3,755,0,1,0,5,1205,4407
2021-01-07,136,483,123,48,790,136,408,122,48,714,77850,60,250,69,33,47294,0,4,4,7,15,0,0,1,4,760,0,0,2,7,1214,4422
2021-01-08,111,433,111,32,687,109,368,111,32,620,78470,67,217,69,18,47665,1,7,15,16,39,0,0,2,2,764,0,0,3,4,1221,4461
2021-01-09,91,341,83,19,534,91,304,82,19,496,78966,48,187,55,11,47966,1,4,6,5,16,0,0,1,3,768,0,0,1,5,1227,4477
2021-01-10,33,145,39,10,227,33,96,39,10,178,79144,10,57,22,10,48065,0,4,7,10,21,0,0,1,2,771,0,0,1,4,1232,4498
2021-01-11,108,483,132,72,795,108,430,132,72,742,79886,49,256,81,34,48485,2,6,5,15,28,0,0,2,4,777,0,0,2,10,1244,4526
2021-01-12,90,369,107,41,607,90,329,107,41,567,80453,47,188,66,23,48809,1,5,5,11,22,0,0,0,1,778,1,0,1,4,1250,4548
2021-01-13,85,342,119,34,580,85,272,119,34,510,80963,43,164,63,20,49099,1,1,8,4,14,0,0,0,4,782,0,0,0,5,1255,4562
2021-01-14,83,337,98,30,548,83,231,98,30,442,81405,39,138,59,19,49354,0,3,5,10,18,0,0,2,2,786,0,0,2,2,1259,4580
2021-01-15,85,290,129,35,539,84,235,129,35,483,81888,56,158,86,16,49670,0,5,7,6,18,0,0,0,4,790,0,0,0,7,1266,4598
2021-01-16,71,286,62,11,430,71,221,62,11,365,82253,32,134,34,4,49874,2,4,2,2,10,0,0,1,5,796,0,0,2,6,1274,4608
2021-01-17,24,126,33,18,201,24,83,33,18,158,82411,10,48,15,14,49961,0,1,5,15,21,0,0,1,3,800,0,0,1,4,1279,4629
2021-01-18,70,315,105,41,531,70,258,105,41,474,82885,29,158,61,24,50233,1,1,5,6,13,0,2,0,1,803,0,3,2,1,1285,4642
2021-01-19,102,307,87,22,518,101,254,86,22,463,83348,47,165,54,16,50515,0,2,8,7,17,0,0,1,4,808,0,0,2,5,1292,4659
2021-01-20,82,311,77,28,498,79,238,77,28,422,83770,53,148,53,22,50791,0,1,9,9,19,0,0,0,1,809,0,0,0,3,1295,4678
2021-01-21,61,297,84,17,459,61,259,84,17,421,84191,29,170,60,11,51061,0,5,11,7,23,0,0,1,2,812,0,0,1,6,1302,4701
2021-01-22,75,269,79,26,449,75,205,79,25,384,84575,42,123,52,14,51292,0,6,8,5,19,0,0,1,3,816,0,0,3,5,1310,4720
2021-01-23,57,220,68,21,366,57,153,68,21,299,84874,41,111,44,12,51500,2,2,4,4,12,0,0,0,3,819,0,0,0,4,1314,4732
2021-01-24,11,76,17,3,107,11,48,17,3,79,84953,2,26,6,2,51536,0,7,3,4,14,0,0,1,5,825,0,0,1,5,1320,4746
2021-01-25,61,269,90,44,464,61,217,90,44,412,85365,37,147,62,21,51803,1,9,5,3,18,0,0,0,2,827,0,0,1,2,1323,4764
2021-01-26,70,251,84,22,427,69,167,84,22,342,85707,44,105,56,14,52022,0,1,7,2,10,0,0,0,3,830,0,0,0,3,1326,4774
2021-01-27,60,245,74,32,411,60,182,73,32,347,86054,33,121,45,24,52245,0,5,3,6,14,0,0,0,3,833,0,0,0,4,1330,4788
2021-01-28,46,261,66,35,408,46,170,63,35,314,86368,29,106,32,19,52431,0,2,3,11,16,0,0,0,2,835,0,0,0,3,1333,4804
2021-01-29,72,177,77,24,350,72,141,76,24,313,86681,33,94,54,14,52626,0,7,4,4,15,0,1,1,1,838,0,1,1,2,1337,4819
2021-01-30,64,200,56,21,341,63,150,56,20,289,86970,38,98,43,13,52818,1,9,2,6,18,0,0,1,4,843,0,0,1,4,1342,4837
2021-01-31,22,116,15,5,158,22,56,15,5,98,87068,11,29,6,5,52869,0,2,3,4,9,0,0,0,1,844,0,0,1,3,1346,4846
2021-02-01,60,237,92,31,420,59,193,92,30,374,87442,39,119,65,19,53111,0,5,4,5,14,0,0,0,1,845,0,0,0,4,1350,4860
2021-02-02,65,252,66,14,397,62,163,65,14,304,87746,32,105,49,11,53308,0,1,5,2,8,0,0,1,2,848,0,0,3,3,1356,4868
2021-02-03,68,229,58,18,373,66,170,57,18,311,88057,41,102,45,10,53506,0,2,6,7,15,0,0,0,2,850,0,0,0,2,1358,4883
2021-02-04,64,199,51,9,323,61,129,51,8,249,88306,40,87,43,6,53682,1,3,3,7,14,0,1,0,4,855,0,1,0,4,1363,4897
2021-02-05,58,160,46,18,282,58,129,46,18,251,88557,29,80,35,15,53841,1,4,7,1,13,0,0,1,4,860,0,0,1,5,1369,4910
2021-02-06,53,185,44,11,293,51,103,42,10,206,88763,29,64,30,8,53972,0,1,5,6,12,0,0,2,0,862,0,0,2,0,1371,4922
2021-02-07,12,75,15,9,111,12,27,14,9,62,88825,4,19,11,6,54012,0,3,2,5,10,0,0,0,3,865,0,0,0,3,1374,4932
2021-02-08,57,212,64,24,357,55,157,63,23,298,89123,30,110,45,17,54214,0,4,2,7,13,0,0,0,1,866,0,0,1,2,1377,4945
2021-02-09,51,178,53,15,297,50,138,52,15,255,89378,31,86,36,10,54377,1,2,2,8,13,0,0,2,1,869,0,0,2,2,1381,4958
2021-02-10,33,184,49,24,290,32,100,49,24,205,89583,21,59,31,16,54504,0,2,3,4,9,0,0,2,1,872,0,0,4,2,1387,4967
2021-02-11,54,168,48,12,282,54,110,48,12,224,89807,27,75,35,7,54648,0,0,2,4,6,0,0,1,1,874,0,0,1,2,1390,4973
2021-02-12,42,153,48,18,261,39,96,47,17,199,90006,27,61,29,13,54778,0,0,4,4,8,0,0,0,2,876,0,0,0,5,1395,4981
2021-02-13,7,67,7,2,83,6,20,7,2,35,90041,4,13,5,1,54801,0,3,5,1,9,0,0,0,0,876,0,0,1,1,1397,4990
2021-02-14,2,36,9,0,47,2,14,9,0,25,90066,1,9,5,0,54816,0,3,2,0,5,0,0,0,0,876,0,0,0,1,1398,4995
2021-02-15,18,118,26,10,172,18,64,26,10,118,90184,10,44,16,7,54893,0,2,3,3,8,0,0,0,2,878,0,0,0,3,1401,5003
2021-02-16,41,239,58,9,347,39,173,58,9,279,90463,20,123,42,7,55085,0,1,2,4,7,0,0,1,4,883,0,0,1,6,1408,5010
2021-02-17,38,164,33,6,241,36,107,33,6,182,90645,20,73,20,3,55201,0,2,3,2,7,0,0,0,5,888,0,0,0,5,1413,5017
2021-02-18,33,285,41,11,370,33,100,39,10,182,90827,25,73,32,8,55339,1,1,1,5,8,0,0,0,1,889,0,0,0,1,1414,5025
2021-02-19,16,118,32,3,169,15,80,31,3,129,90956,9,51,22,1,55422,0,4,5,1,10,0,0,2,4,895,0,0,2,5,1421,5035
2021-02-20,21,145,34,3,203,21,75,34,3,133,91089,10,61,28,2,55523,0,4,6,2,12,0,0,0,3,898,0,0,0,5,1426,5047
2021-02-21,16,105,11,5,137,14,30,11,5,60,91149,8,20,6,3,55560,1,4,3,4,12,0,0,1,2,901,0,0,1,3,1430,5059
2021-02-22,38,177,36,11,262,38,114,35,11,198,91347,20,79,26,11,55696,0,1,3,3,7,0,0,1,2,904,0,1,2,2,1435,5066
2021-02-23,30,258,31,3,322,29,120,30,2,181,91528,19,82,21,2,55820,0,2,1,0,3,0,0,0,0,904,0,1,0,0,1436,5069
2021-02-24,30,259,34,10,333,28,86,31,10,155,91683,18,61,20,8,55927,0,1,2,4,7,0,0,1,2,907,0,0,1,2,1439,5076
2021-02-25,35,185,37,12,269,35,105,36,12,188,91871,29,72,25,10,56063,0,2,1,0,3,0,0,0,1,908,0,1,0,2,1442,5079
2021-02-26,32,172,32,7,243,32,87,29,6,154,92025,22,57,19,6,56167,0,2,1,5,8,0,0,1,3,912,0,0,2,6,1450,5087
2021-02-27,24,129,27,5,185,24,74,27,5,130,92155,16,56,20,2,56261,0,2,1,0,3,0,1,0,3,916,0,1,1,4,1456,5090
2021-02-28,11,107,15,0,133,11,22,14,0,47,92202,9,17,10,0,56297,0,3,3,0,6,0,0,1,0,917,0,0,1,0,1457,5096
2021-03-01,45,175,33,8,261,45,123,33,8,209,92411,27,81,18,7,56430,0,4,4,1,9,0,0,0,0,917,0,0,0,0,1457,5105
2021-03-02,42,160,40,8,250,42,103,40,7,192,92603,21,63,31,5,56550,1,2,1,2,6,0,0,0,1,918,0,0,0,2,1459,5111
2021-03-03,35,124,19,5,183,35,93,19,5,152,92755,25,51,13,4,56643,1,5,1,1,8,0,0,1,0,919,0,0,1,0,1460,5119
2021-03-04,22,249,38,5,314,22,79,38,5,144,92899,6,53,27,2,56731,0,2,0,1,3,0,1,0,2,922,0,1,0,2,1463,5122
2021-03-05,43,214,30,8,295,43,97,28,7,175,93074,23,69,19,3,56845,2,0,1,1,4,0,0,0,1,923,0,0,0,2,1465,5126
2021-03-06,26,92,16,3,137,25,59,15,3,102,93176,12,50,8,3,56918,0,2,2,0,4,0,0,0,0,923,0,0,1,1,1467,5130
2021-03-07,11,53,9,6,79,10,21,9,6,46,93222,4,17,7,6,56952,0,3,3,2,8,0,0,0,0,923,0,0,0,0,1467,5138
2021-03-08,56,156,45,12,269,55,124,44,12,235,93457,37,89,35,8,57121,0,2,1,2,5,0,0,1,0,924,0,0,3,0,1470,5143
2021-03-09,36,340,45,11,432,36,108,44,11,199,93656,23,71,32,8,57255,0,1,6,0,7,0,0,0,1,925,0,0,0,2,1472,5150
2021-03-10,38,509,32,4,583,38,115,32,4,189,93845,23,87,26,4,57395,0,4,3,3,10,0,0,0,1,926,0,0,0,1,1473,5160
2021-03-11,43,291,33,3,370,43,100,33,3,179,94024,26,79,24,2,57526,0,0,2,1,3,0,0,0,2,928,0,0,1,3,1477,5163
2021-03-12,41,313,33,7,394,41,80,33,7,161,94185,29,61,22,6,57644,0,1,3,1,5,0,0,0,0,928,0,0,0,0,1477,5168
2021-03-13,44,121,25,7,197,43,80,25,7,155,94340,26,52,21,4,57747,0,3,0,1,4,0,0,1,1,930,0,0,1,1,1479,5172
2021-03-14,12,69,11,3,95,12,24,11,3,50,94390,8,12,8,3,57778,2,1,7,4,14,0,0,1,0,931,0,0,2,1,1482,5186
2021-03-15,58,192,48,11,309,57,160,47,11,275,94665,35,103,33,7,57956,0,1,4,2,7,0,0,0,2,933,0,0,0,2,1484,5193
2021-03-16,53,601,29,3,686,53,134,29,3,219,94884,41,90,20,2,58109,0,2,4,1,7,0,0,0,1,934,0,0,0,1,1485,5200
2021-03-17,44,523,33,4,604,44,124,32,4,204,95088,21,95,24,2,58251,0,2,3,0,5,0,0,0,1,935,0,0,0,1,1486,5205
2021-03-18,44,209,55,3,311,44,140,54,3,241,95329,26,107,36,2,58422,0,5,7,1,13,0,0,0,1,936,0,0,0,1,1487,5218
2021-03-19,47,175,39,8,269,47,121,38,7,213,95542,30,75,30,7,58564,0,6,5,0,11,0,0,1,0,937,0,0,1,1,1489,5229
2021-03-20,37,126,43,8,214,36,96,42,8,182,95724,23,71,27,5,58690,1,2,2,1,6,0,0,0,2,939,0,0,1,2,1492,5235
2021-03-21,14,176,19,3,212,14,44,19,3,80,95804,9,29,12,1,58741,0,4,3,0,7,0,0,0,0,939,0,0,0,0,1492,5242
2021-03-22,79,294,72,13,458,79,193,71,13,356,96160,31,106,32,7,58917,0,0,3,3,6,0,0,0,0,0,0,0,0,0,1492,5248
2021-03-23,73,809,42,6,930,73,201,42,6,322,96482,33,94,15,2,59061,1,2,2,3,8,0,0,0,1,940,0,0,0,1,1493,5256
2021-03-24,65,789,54,6,914,64,206,53,6,329,96811,33,132,36,5,59267,0,6,7,1,14,0,0,0,1,941,0,0,0,2,1495,5270
2021-03-25,76,481,47,11,615,75,187,47,11,320,97131,47,130,32,9,59485,0,3,0,4,7,0,0,1,1,943,0,0,1,1,1497,5277
2021-03-26,55,444,44,9,552,54,163,44,9,270,97401,29,110,31,7,59662,1,4,3,3,11,0,0,0,0,943,0,0,0,0,1497,5288
2021-03-27,28,234,28,5,295,27,97,28,5,157,97558,15,71,23,4,59775,0,2,1,3,6,0,0,0,1,944,0,0,0,1,1498,5294
2021-03-28,6,155,15,2,178,6,28,15,2,51,97609,3,19,12,2,59811,0,2,8,1,11,0,0,1,0,945,0,0,1,0,1499,5305
2021-03-29,45,337,55,6,443,44,182,55,6,287,97896,36,141,43,4,60035,0,2,0,3,5,0,0,0,1,946,0,0,0,1,1500,5310
2021-03-30,46,467,34,4,551,46,155,34,4,239,98135,28,110,24,3,60200,0,1,6,0,7,0,0,0,1,947,0,0,1,1,1502,5317
2021-03-31,30,306,47,4,387,30,140,47,4,221,98356,18,110,38,4,60370,0,7,2,2,11,0,0,0,0,947,0,0,0,1,1503,5328
2021-04-01,55,308,42,9,414,55,148,41,9,253,98609,33,103,35,7,60548,0,6,3,2,11,0,0,1,0,948,0,0,1,0,1504,5339
2021-04-02,57,296,33,1,387,56,126,33,1,216,98825,37,93,22,0,60700,1,4,3,1,9,0,0,0,2,950,0,0,0,2,1506,5348
2021-04-03,48,239,29,3,319,48,101,29,3,181,99006,32,69,25,2,60828,0,3,1,1,5,0,0,0,0,950,0,0,0,0,1506,5353
2021-04-04,10,125,8,3,146,10,28,8,3,49,99055,4,17,6,3,60858,0,2,0,4,6,0,0,1,0,951,0,0,1,0,1507,5359
2021-04-05,72,353,67,9,501,72,194,66,9,341,99396,43,152,48,9,61110,2,9,4,3,18,0,0,0,1,952,0,0,0,1,1508,5377
2021-04-06,25,321,31,4,381,25,163,31,4,223,99619,16,114,26,3,61269,0,4,6,3,13,0,0,0,1,953,0,0,0,1,1509,5390
2021-04-07,51,356,27,7,441,50,165,26,7,248,99867,29,124,12,6,61440,1,1,4,2,8,0,0,0,0,953,0,0,0,0,1509,5398
2021-04-08,51,347,33,4,435,49,174,33,4,260,100127,29,122,19,2,61612,1,8,3,1,13,0,0,0,0,953,0,0,1,0,1510,5411
2021-04-09,58,338,56,13,465,47,170,54,12,283,100410,30,126,37,8,61813,1,7,1,5,14,0,0,0,2,955,0,0,0,3,1513,5425
2021-04-10,45,234,37,6,322,44,116,37,6,203,100613,30,75,29,6,61953,0,4,2,5,11,0,1,0,3,959,0,1,0,5,1519,5436
2021-04-11,19,131,8,2,160,19,51,8,2,80,100693,7,37,5,2,62004,0,5,2,1,8,0,0,0,0,959,0,1,0,0,1520,5444
2021-04-12,94,354,72,13,533,82,249,70,11,412,101105,39,156,44,7,62250,0,3,8,2,13,0,0,0,2,961,0,0,0,2,1522,5457
2021-04-13,86,347,70,3,506,86,252,67,3,408,101513,47,157,44,3,62501,1,4,5,1,11,0,0,2,2,965,0,0,4,2,1528,5468
2021-04-14,99,535,80,5,719,98,273,80,5,456,101969,43,164,52,3,62763,0,7,9,0,16,0,0,1,0,966,0,0,1,0,1529,5484
2021-04-15,84,689,84,10,867,81,274,82,10,447,102416,44,182,51,3,63043,2,8,11,3,24,0,0,0,1,967,0,0,0,1,1530,5508
2021-04-16,104,310,69,9,492,99,238,58,9,404,102820,50,154,32,7,63286,0,14,7,5,26,0,0,0,0,967,0,1,0,0,1531,5534
2021-04-17,85,278,57,9,429,82,210,47,9,348,103168,51,128,28,8,63501,0,11,5,3,19,0,1,0,0,968,0,1,0,0,1532,5553
2021-04-18,22,110,25,3,160,20,64,21,3,108,103276,10,32,10,2,63555,1,7,4,2,14,0,0,1,1,970,0,0,2,1,1535,5567
2021-04-19,126,564,139,22,851,111,343,107,19,580,103856,45,184,56,7,63847,0,11,6,2,19,0,0,0,0,970,0,0,0,0,1535,5586
2021-04-20,153,499,157,31,840,132,297,59,11,499,104355,60,152,34,8,64101,2,3,4,3,12,1,0,0,0,971,1,0,0,0,1536,5598
2021-04-21,137,531,120,34,822,118,301,71,12,502,104857,54,177,38,10,64380,1,11,5,2,19,0,0,0,0,971,0,0,0,0,1536,5617
2021-04-22,128,349,94,11,582,117,247,71,7,442,105299,61,144,39,4,64628,2,11,11,3,27,0,1,2,0,974,0,1,3,0,1540,5644
2021-04-23,99,353,67,9,528,92,252,55,6,405,105704,61,139,35,4,64867,0,4,10,3,17,0,0,1,1,976,0,0,1,1,1542,5661
2021-04-24,104,355,122,42,623,86,174,59,11,330,106034,51,108,33,6,65065,1,11,5,4,21,0,0,0,0,976,0,0,1,0,1543,5682
2021-04-25,64,178,66,15,323,21,54,17,1,93,106127,11,25,11,0,65112,1,9,5,1,16,0,1,0,1,978,0,1,0,1,1545,5698
2021-04-26,172,444,155,32,803,149,308,102,15,574,106701,70,173,57,9,65421,1,5,10,3,19,0,1,1,0,980,0,1,2,0,1548,5717
2021-04-27,136,621,81,16,854,126,304,74,9,513,107214,62,179,41,6,65709,1,10,11,2,24,0,0,0,1,981,0,0,1,2,1551,5741
2021-04-28,122,661,68,11,862,122,279,68,11,480,107694,59,156,35,7,65966,2,8,10,4,24,0,0,0,0,981,0,0,2,0,1553,5765
2021-04-29,115,449,80,12,656,115,263,80,12,470,108164,66,156,49,9,66246,0,4,6,0,10,0,0,0,0,981,0,0,0,0,1553,5775
2021-04-30,115,377,54,7,553,115,248,54,7,424,108588,53,146,35,2,66482,0,11,3,5,19,0,0,0,1,982,0,0,0,2,1555,5794
2021-05-01,55,509,33,7,604,55,147,33,7,242,108830,21,86,20,5,66614,0,4,5,4,13,0,0,0,0,982,0,1,0,0,1556,5807
2021-05-02,20,290,19,7,336,20,56,19,7,102,108932,8,26,11,4,66663,0,9,0,0,9,0,0,0,3,985,0,0,0,3,1559,5816
2021-05-03,123,624,84,9,840,123,301,84,9,517,109449,69,175,54,5,66966,0,6,6,0,12,0,0,0,0,985,0,0,0,1,1560,5828
2021-05-04,110,611,53,6,780,110,234,53,6,403,109852,56,150,31,3,67206,0,6,12,4,22,0,0,1,0,986,0,0,1,0,1561,5850
2021-05-05,116,321,49,8,494,116,200,49,8,373,110225,59,118,24,6,67413,0,8,3,3,14,0,0,0,1,987,0,0,0,1,1562,5864
2021-05-06,99,443,39,7,588,99,183,39,7,328,110553,50,111,19,6,67599,1,4,9,3,17,0,1,1,1,990,0,1,1,1,1565,5881
2021-05-07,91,342,46,9,488,91,157,46,9,303,110856,62,98,32,4,67795,1,4,8,2,15,0,0,1,0,991,0,0,1,1,1567,5896
2021-05-08,57,204,31,6,298,57,106,31,6,200,111056,42,65,13,2,67917,1,2,7,4,14,0,0,0,2,993,0,0,0,3,1570,5910
2021-05-09,10,305,16,3,334,10,37,16,3,66,111122,5,18,8,3,67951,0,7,4,2,13,0,0,0,1,994,0,1,0,2,1573,5923
2021-05-10,95,353,48,6,502,95,206,48,6,355,111477,63,125,29,2,68170,0,6,2,1,9,0,0,0,0,994,0,0,0,1,1574,5932
2021-05-11,66,216,40,8,330,66,142,40,8,256,111733,46,75,26,4,68321,0,5,10,1,16,0,0,0,0,994,0,0,2,0,1576,5948
2021-05-12,80,224,48,11,363,80,145,48,11,284,112017,53,90,24,5,68493,1,8,8,2,19,0,1,1,1,997,0,1,1,2,1580,5967
2021-05-13,66,440,22,7,535,66,117,22,7,212,112229,43,73,17,6,68632,0,6,2,4,12,0,1,0,1,999,0,1,0,3,1584,5979
2021-05-14,67,645,34,4,750,67,109,34,4,214,112443,31,71,18,3,68755,0,3,7,2,12,0,0,2,1,1002,0,0,2,1,1587,5991
2021-05-15,46,177,33,7,263,46,82,33,7,168,112611,28,47,20,4,68854,0,4,5,2,11,0,0,1,0,1003,0,0,1,1,1589,6002
2021-05-16,12,203,13,0,228,12,33,13,0,58,112669,6,18,7,0,68885,0,5,2,0,7,0,0,0,0,1003,0,0,0,0,1589,6009
2021-05-17,83,364,38,7,492,83,140,38,7,268,112937,48,88,24,5,69050,2,7,2,2,13,0,0,0,1,1004,0,1,0,1,1591,6022
2021-05-18,60,562,27,12,661,60,83,27,12,182,113119,33,57,16,11,69167,0,6,3,3,12,0,0,1,1,1006,0,1,1,1,1594,6034
2021-05-19,56,1008,33,7,1104,56,79,33,7,175,113294,34,48,26,4,69279,1,1,8,1,11,0,0,0,2,1008,0,0,0,2,1596,6045
2021-05-20,42,255,27,7,331,42,69,27,7,145,113439,29,39,20,6,69373,2,4,4,0,10,0,0,0,1,1009,0,0,1,1,1598,6055
2021-05-21,34,579,23,4,640,34,72,23,4,133,113572,20,51,14,0,69458,2,4,4,1,11,0,1,0,0,1010,0,2,0,1,1601,6066
2021-05-22,45,77,23,3,148,45,66,23,3,137,113709,28,44,14,2,69546,0,4,3,0,7,0,0,0,1,1011,0,1,0,2,1604,6073
2021-05-23,11,344,6,3,364,11,26,6,3,46,113755,6,15,4,2,69573,0,6,2,2,10,0,0,0,0,1011,0,0,0,2,1606,6083
2021-05-24,50,239,21,7,317,50,105,21,7,183,113938,27,65,12,4,69681,0,4,4,4,12,0,0,2,2,1015,0,0,2,2,1610,6095
2021-05-25,42,210,23,6,281,42,79,23,6,150,114088,20,44,13,3,69761,1,4,2,1,8,0,0,0,1,1016,0,0,0,2,1612,6103
2021-05-26,44,924,13,1,982,44,69,13,1,127,114215,31,37,12,1,69842,1,7,3,0,11,0,0,0,0,1016,0,1,1,1,1615,6114
2021-05-27,40,382,16,5,443,40,67,16,5,128,114343,30,33,9,2,69916,1,3,4,1,9,0,0,0,0,1016,0,0,0,0,1615,6123
2021-05-28,40,371,20,4,435,40,50,20,4,114,114457,26,36,15,3,69996,2,3,3,0,8,0,0,0,1,1017,0,1,0,1,1617,6131
2021-05-29,18,150,12,8,188,18,35,12,8,73,114530,10,28,9,7,70050,0,2,2,2,6,0,0,1,0,1018,0,0,1,0,1618,6137
2021-05-30,6,150,5,1,162,6,15,5,1,27,114557,6,12,3,0,70071,2,9,1,0,12,0,0,1,1,1020,0,0,1,2,1621,6149
2021-05-31,16,144,9,1,170,16,28,9,1,54,114611,11,16,4,0,70102,0,2,2,1,5,0,1,0,0,1021,0,1,0,0,1622,6154
2021-06-01,59,439,18,6,522,59,83,18,6,166,114777,41,61,9,5,70218,0,4,3,5,12,0,0,1,0,1022,0,0,1,0,1623,6166
2021-06-02,23,204,18,4,249,23,70,18,4,115,114892,16,44,13,3,70294,1,5,1,1,8,0,0,0,2,1024,0,0,0,3,1626,6174
2021-06-03,33,409,25,2,469,33,50,25,2,110,115002,16,33,14,1,70358,0,2,2,0,4,0,0,0,0,1024,0,0,0,0,1626,6178
2021-06-04,37,638,17,3,695,37,42,17,3,99,115101,26,22,10,3,70419,0,2,0,1,3,0,0,2,0,1026,0,0,2,0,1628,6181
2021-06-05,31,131,6,4,172,31,44,6,4,85,115186,16,32,3,4,70474,1,0,0,5,6,0,0,0,0,1026,0,0,0,0,1628,6187
2021-06-06,2,207,2,3,214,2,17,2,3,24,115210,2,9,1,3,70489,0,1,1,2,4,0,1,0,1,1028,0,1,0,1,1630,6191
2021-06-07,25,107,14,5,151,25,52,14,5,96,115306,16,37,10,3,70555,0,2,3,1,6,0,0,0,0,1028,0,0,0,0,1630,6197
2021-06-08,26,437,20,5,488,26,46,20,5,97,115403,13,31,13,1,70613,0,1,4,1,6,0,0,0,0,1028,0,0,0,1,1631,6203
2021-06-09,27,319,12,7,365,27,47,12,7,93,115496,16,29,7,5,70670,0,4,1,3,8,0,0,0,1,1029,0,0,0,1,1632,6211
2021-06-10,31,186,9,2,228,31,39,9,2,81,115577,20,24,4,0,70718,0,3,2,0,5,0,0,0,0,1029,0,0,0,0,1632,6216
2021-06-11,24,969,11,5,1009,24,48,11,5,88,115665,10,32,8,5,70773,0,3,0,2,5,0,0,0,1,1030,0,0,0,1,1633,6221
2021-06-12,14,165,11,2,192,14,16,11,2,43,115708,7,10,6,2,70798,0,2,1,1,4,0,0,0,0,1030,0,0,0,0,1633,6225
2021-06-13,10,87,6,1,104,10,20,6,1,37,115745,8,14,3,0,70823,1,3,1,0,5,0,1,0,0,1031,0,1,0,0,1634,6230
2021-06-14,28,139,20,6,193,28,50,20,6,104,115849,12,33,12,2,70882,1,1,2,0,4,0,0,0,0,1031,0,0,0,0,1634,6234
2021-06-15,15,173,16,3,207,15,31,16,3,65,115914,2,20,6,1,70911,0,2,2,0,4,0,0,0,0,0,0,0,0,0,1634,6238
2021-06-16,7,808,12,2,829,7,35,12,2,56,115970,1,8,3,2,70925,0,4,4,3,11,0,0,0,0,0,0,0,0,0,1634,6249
2021-06-17,12,535,11,1,559,12,32,11,1,56,116026,0,3,0,0,70928,0,1,1,1,3,0,0,0,0,0,0,0,0,0,1634,6252
2021-06-18,13,379,7,2,401,13,21,7,2,43,116069,1,0,0,1,70930,0,0,0,0,3,0,0,0,0,0,0,0,0,0,1634,6255
2021-06-19,2,165,1,1,169,2,1,1,1,5,116074,0,0,0,0,70930,0,0,0,0,0,0,0,0,0,0,0,0,0,0,1634,6255
